8
10 12 15 20 25 30 35 40
45 50 55 60 65 70 75 80
85 90 95 100 105 110 115 120
125 130 135 140 145 150 155 160
165 170 175 180 185 190 195 200
205 210 215 220 225 230 235 240
245 250 255 260 265 270 275 280
285 290 295 300 305 310 315 320
325 330 335 340 345 350 355 360
365 370 375 380 385 390 395 400
405 410 415 420 425 430 435 440
445 450 455 460 465 470 475 480
485 490 495 500 505 510 515 520
525 530 535 540 545 550 555 560
565 570 575 580 585 590 595 600
605 610 615 620 625 630 635 640
1 2 3 4 5 6 7 8
9 10 11 12 13 14 15 16
17 18 19 20 21 22 23 24
25 26 27 28 29 30 31 32
33 34 35 36 37 38 39 40
41 42 43 44 45 46 47 48
49 50 51 52 53 54 55 56
57 58 59 60 61 62 63 64
65 66 67 68 69 70 71 72
73 74 75 76 77 78 79 80
81 82 83 84 85 86 87 88
89 90 91 92 93 94 95 96
97 98 99 100 101 102 103 104
105 106 107 108 109 110 111 112
113 114 115 116 117 118 119 120
121 122 123 124 125 126 127 128
10 12 15 20 25 30 35 40
45 50 55 60 65 70 75 80
85 90 95 100 105 110 115 120
125 130 135 140 145 150 155 160
165 170 175 180 185 190 195 200
205 210 215 220 225 230 235 240
245 250 255 260 265 270 275 280
285 290 295 300 305 310 315 320
325 330 335 340 345 350 355 360
365 370 375 380 385 390 395 400
405 410 415 420 425 430 435 440
445 450 455 460 465 470 475 480
485 490 495 500 505 510 515 520
525 530 535 540 545 550 555 560
565 570 575 580 585 590 595 600
605 610 615 620 625 630 635 640
1 2 3 4 5 6 7 8
9 10 11 12 13 14 15 16
17 18 19 20 21 22 23 24
25 26 27 28 29 30 31 32
33 34 35 36 37 38 39 40
41 42 43 44 45 46 47 48
49 50 51 52 53 54 55 56
57 58 59 60 61 62 63 64
65 66 67 68 69 70 71 72
73 74 75 76 77 78 79 80
81 82 83 84 85 86 87 88
89 90 91 92 93 94 95 96
97 98 99 100 101 102 103 104
105 106 107 108 109 110 111 112
113 114 115 116 117 118 119 120
121 122 123 124 125 126 127 128